7	7
w	w	1	1	w	w	w
w	*	1	1	1	w	w
1	1	1	1	1	1	w
1	1	1	*	1	1	1
w	1	1	1	1	1	1
w	w	1	1	1	*	w
w	w	w	1	1	w	w