5	5
1	1	1	1	1
1	1	1	1	1
2	2	2	2	2
2	2	2	2	2
0	0	0	0	0