9	9
-	-	2	0	p2	-	-	-	-
-	2	1	1	0	p2	-	-	-
1	1	*	2	1	1	p2	-	-
0	2	0	1	0	0	0	p2	-
p1	0	2	1	2	1	1	2	p2
-	p1	1	0	0	2	1	0	0
-	-	p1	2	2	0	*	1	1
-	-	-	p1	1	2	0	1	-
-	-	-	-	p1	1	1	-	-